18 18 18 18 18 18 18 18 18 18 18 18 18 18 18 18 18 18 18 18 18 18 18 18 18 18 18 18 18 18 18 18 18 18 18 18 18 18 18 18 18 18 18 18 18 18 18 18 18 18 
18 18 18 18 18 18 18 18 18 18 18 18 18 18 18 18 18 18 18 18 18 18 18 18 18 18 18 18 18 18 18 18 18 18 18 18 18 18 18 18 18 18 18 18 18 18 18 18 18 18 
18 18 18 18 18 18 18 0 0 18 18 18 18 18 18 18 18 18 18 18 18 18 18 18 18 18 18 18 18 18 18 18 18 18 18 18 18 18 18 18 18 18 18 18 18 18 18 18 18 18 
18 18 18 18 18 18 18 0 0 18 18 18 18 18 18 18 18 18 18 18 18 18 18 18 18 18 18 18 18 18 18 18 18 18 18 18 18 18 18 18 18 18 0 18 18 18 18 18 18 18 
18 18 18 18 18 18 18 0 18 18 18 18 18 18 18 18 18 18 18 18 18 18 18 18 18 18 18 18 18 18 18 18 18 18 18 18 18 18 18 18 18 18 0 0 18 18 18 18 18 18 
18 18 18 18 18 18 18 18 18 18 18 18 18 18 18 18 18 18 18 18 18 18 18 18 18 18 18 18 18 18 18 18 18 18 18 18 18 18 18 18 18 18 18 18 18 18 18 18 18 18 
18 18 18 18 18 18 18 18 18 18 18 18 18 18 18 17 13 13 13 13 13 13 13 13 13 13 13 13 13 13 13 13 13 13 13 13 13 25 18 18 18 18 18 18 18 18 18 18 18 18 
18 18 18 18 18 18 18 18 18 18 18 18 18 18 18 5 15 15 15 15 15 15 15 15 15 15 15 15 15 15 15 15 15 9 15 15 15 8 18 18 18 18 18 18 18 18 18 18 18 18 
18 18 18 18 18 18 18 18 18 18 18 18 18 18 18 5 15 15 15 15 15 15 15 15 15 15 15 15 15 15 15 15 15 15 15 15 15 8 18 18 18 18 18 18 18 18 18 18 18 18 
18 18 18 18 18 18 18 18 18 18 18 18 18 18 18 5 15 21 3 3 3 3 3 3 3 3 3 3 3 3 3 3 3 22 15 15 15 8 18 18 18 18 18 18 18 18 18 18 18 18 
18 18 18 18 18 18 18 18 18 18 18 18 18 18 18 5 15 4 14 14 14 14 14 14 14 14 14 14 14 14 14 14 14 2 15 15 15 8 18 18 18 18 18 18 18 18 18 18 18 18 
18 18 18 18 18 17 13 13 13 13 13 13 13 13 13 15 15 4 14 14 14 14 14 14 14 14 14 14 14 14 14 14 14 2 15 15 15 8 18 18 18 18 18 18 18 18 18 18 18 18 
18 18 18 18 18 5 15 15 15 15 15 15 21 3 3 3 3 14 14 14 14 14 14 14 14 14 14 14 14 14 14 14 14 2 15 15 15 15 13 13 13 13 25 18 18 18 18 18 18 18 
18 18 18 18 18 5 15 15 15 15 15 21 14 14 14 14 14 14 14 14 14 14 14 14 14 14 14 14 14 14 14 14 14 14 3 3 3 22 15 15 15 15 8 18 18 18 18 18 18 18 
18 18 18 18 18 5 15 15 15 15 21 14 14 14 14 14 14 14 14 14 14 14 14 14 14 14 14 14 14 14 14 14 14 14 14 14 14 2 15 15 15 15 8 18 18 18 18 18 18 18 
18 18 18 18 18 5 15 15 15 21 14 14 14 14 14 14 14 14 14 14 14 14 6 14 14 14 14 14 14 14 14 14 14 14 14 14 14 2 15 15 15 15 8 18 18 18 18 18 18 18 
18 18 18 18 18 5 15 15 15 4 14 14 14 14 14 14 14 14 14 14 14 14 14 14 14 14 14 14 14 14 14 14 14 14 14 14 14 2 15 15 9 15 8 18 18 18 18 18 18 18 
18 18 18 18 18 5 15 15 15 4 14 14 14 14 14 14 14 14 14 14 14 14 14 14 14 14 14 14 14 14 14 14 14 14 14 14 14 2 15 15 15 15 8 18 18 18 18 18 18 18 
18 18 18 18 18 5 15 15 15 4 14 14 14 14 14 14 14 14 14 14 14 14 14 14 14 14 14 14 14 14 14 6 14 14 14 14 14 2 15 15 15 15 8 18 18 18 18 18 18 18 
18 18 18 18 18 5 15 15 15 4 14 14 14 14 14 14 14 14 14 14 14 14 14 14 14 14 14 14 14 14 14 14 14 14 14 14 14 2 15 15 15 15 11 18 18 18 18 18 18 18 
18 18 18 18 18 5 15 15 9 4 14 14 14 14 14 14 14 14 14 14 14 14 14 14 14 14 14 14 14 14 14 14 14 14 14 14 14 2 15 15 15 11 18 18 18 18 18 18 18 18 
18 18 18 18 18 5 15 15 15 4 14 14 14 14 14 14 14 14 14 14 14 14 14 14 14 14 14 14 14 14 14 14 14 14 14 14 14 2 15 15 8 18 18 18 18 18 18 18 18 18 
18 18 18 18 18 5 15 15 15 24 14 14 14 14 14 14 14 14 14 14 14 14 14 14 14 14 14 14 14 14 14 14 14 14 14 14 14 2 15 15 8 18 18 18 18 18 18 18 18 18 
18 0 0 18 18 5 15 15 15 15 24 14 14 14 14 14 14 14 14 14 14 14 14 6 14 14 14 14 14 14 14 14 14 14 14 14 14 2 15 15 15 25 18 18 18 18 18 18 18 18 
18 18 0 18 18 12 7 15 15 15 15 24 1 1 14 14 14 14 14 14 14 14 14 14 14 14 14 14 14 14 14 14 14 14 14 14 14 2 15 15 15 15 25 18 18 18 18 18 18 18 
18 18 18 18 18 18 18 5 15 15 15 15 15 15 4 14 14 14 14 14 14 14 14 14 14 14 14 14 14 14 14 14 14 14 14 1 1 23 15 15 15 15 8 18 18 18 18 18 18 18 
18 18 18 18 18 18 18 5 15 15 15 15 15 15 4 14 14 14 14 14 14 14 14 14 14 14 14 14 14 14 14 14 14 14 2 15 15 15 15 15 15 15 8 18 18 18 18 18 18 18 
18 18 18 18 18 18 18 5 15 15 15 15 15 15 4 14 14 14 14 14 14 14 14 14 14 14 14 14 14 14 14 14 14 14 2 15 15 15 15 15 15 15 11 18 18 18 18 18 18 18 
18 18 18 18 18 18 18 5 15 15 15 15 15 15 4 14 14 14 14 14 14 14 14 14 14 14 14 14 14 14 14 14 14 14 2 15 15 7 15 15 15 10 18 18 18 18 18 18 18 18 
18 18 18 18 18 18 18 5 15 15 15 15 15 15 4 14 14 14 14 14 14 14 14 14 14 14 14 14 14 14 14 14 14 14 2 15 8 18 12 7 10 18 18 18 18 18 18 18 18 18 
18 18 18 18 18 18 18 5 15 15 15 15 15 15 4 14 14 14 14 14 14 14 14 14 14 14 14 14 14 14 14 14 14 14 2 15 8 18 18 18 18 18 18 18 18 18 18 18 18 18 
18 18 18 18 18 18 18 5 15 15 15 15 15 15 4 14 14 14 14 14 14 14 14 14 14 14 14 14 14 14 14 14 14 14 2 15 8 18 18 18 18 18 18 18 18 18 18 18 18 18 
18 18 18 18 18 18 18 12 7 7 7 7 7 15 4 14 14 14 14 14 14 14 14 14 14 14 14 14 14 14 14 14 14 14 2 15 8 18 18 18 18 18 18 18 18 18 18 18 18 18 
18 18 18 18 18 18 18 18 18 18 18 18 18 5 24 1 14 14 14 14 14 14 14 14 14 14 14 14 14 14 14 14 14 1 23 15 8 18 18 18 18 18 18 18 18 18 18 18 18 18 
18 18 18 18 18 18 18 18 18 18 18 18 18 5 15 15 4 14 14 14 14 14 14 14 14 14 14 14 14 14 14 14 2 15 15 15 8 18 18 18 18 18 18 18 18 18 18 18 18 18 
18 18 18 18 18 18 18 18 18 18 18 18 18 5 15 15 4 14 14 14 14 14 14 14 14 14 14 14 14 14 14 14 2 15 15 15 8 18 18 18 18 18 18 18 18 18 18 18 18 18 
18 18 18 18 18 18 18 18 18 18 18 18 18 5 15 15 4 14 14 14 14 14 14 14 14 14 14 14 14 14 14 14 2 15 15 15 8 18 18 18 18 18 18 18 18 18 18 18 18 18 
18 18 18 18 18 18 18 18 18 18 18 18 18 5 15 15 4 14 14 14 14 14 14 14 14 14 14 14 14 14 14 14 23 15 15 15 8 18 18 18 18 18 18 18 18 18 18 18 18 18 
18 18 18 18 18 18 18 18 18 18 18 18 18 5 15 15 4 14 14 14 14 14 14 14 14 14 14 14 14 14 14 23 15 7 7 7 11 18 18 18 18 18 18 18 18 18 18 18 18 18 
18 18 18 18 18 18 18 18 18 18 18 18 18 5 15 15 24 1 1 14 14 14 14 14 14 14 14 14 1 1 23 15 8 18 18 18 18 18 18 18 18 18 18 18 18 18 18 18 18 18 
18 18 18 18 18 18 18 18 18 18 18 18 18 5 15 15 15 15 15 4 14 14 14 14 14 14 14 2 15 15 15 15 8 18 18 18 18 18 18 18 18 18 18 18 18 18 18 18 18 18 
18 18 18 18 18 18 18 18 18 18 18 18 18 12 7 7 7 15 15 4 14 14 14 14 14 14 14 2 15 15 15 15 8 18 18 18 18 18 18 18 18 18 18 18 18 18 18 18 18 18 
18 18 18 18 18 18 18 18 18 18 18 18 18 18 18 18 18 5 15 4 14 14 14 14 14 14 14 2 15 15 15 15 8 18 18 18 18 18 18 18 18 18 18 18 18 18 18 18 18 18 
18 18 18 18 18 18 18 18 18 18 18 18 18 18 18 18 18 5 15 4 14 14 14 14 14 14 14 2 15 15 15 15 8 18 18 18 18 18 18 18 18 18 18 18 18 18 18 18 18 18 
18 18 18 18 18 18 18 18 18 18 18 18 18 18 18 18 18 5 15 4 14 14 14 14 14 14 14 2 15 15 15 15 8 18 18 18 18 18 18 18 18 18 18 18 18 18 18 18 18 18 
18 18 18 18 18 18 18 18 18 18 18 18 18 18 18 18 18 5 15 4 14 14 14 14 14 14 14 2 15 15 15 15 8 18 18 18 18 18 18 18 18 18 18 18 18 18 18 18 18 18 
18 18 18 18 18 18 18 18 18 18 18 18 18 18 18 18 18 5 15 4 14 14 14 14 14 14 14 2 15 15 15 15 8 18 18 18 18 18 18 18 18 18 18 18 18 18 18 18 18 18 
18 18 18 18 18 18 18 18 18 18 18 18 18 18 18 18 18 5 15 4 14 14 14 14 14 14 14 2 15 15 15 15 8 18 18 18 18 18 18 18 18 18 18 18 18 18 18 18 18 18 
18 18 18 18 18 18 18 18 18 18 18 18 18 18 18 18 18 5 15 24 1 1 1 1 1 1 1 23 15 15 15 15 8 18 18 18 18 18 18 18 18 18 18 18 18 18 18 18 18 18 
18 18 18 18 18 18 18 18 18 18 18 18 18 18 18 18 18 5 15 15 15 15 15 15 15 15 15 15 15 15 15 15 8 18 18 18 18 18 18 18 18 18 18 18 18 18 18 18 18 18 
