45 45 45 45 45 45 45 45 45 45 45 45 45 45 45 45 45 45 45 45 45 45 45 45 45 45 45 45 45 45 45 45 45 45 45 45 45 45 45 45 45 45 45 45 45 45 45 45 45 45 
45 45 45 45 45 45 45 45 45 45 45 45 45 45 45 45 45 45 45 45 45 45 45 45 45 45 45 45 45 45 45 45 45 45 45 45 45 45 45 45 45 45 45 45 45 45 45 45 45 45
45 45 45 45 45 45 45 00 00 45 45 45 45 45 45 45 45 45 45 45 45 45 45 45 45 45 45 45 45 45 45 45 45 45 45 45 45 45 45 45 72 45 72 45 45 45 45 45 45 45
45 45 45 45 45 45 45 00 00 45 45 45 45 45 45 72 45 72 45 45 45 45 45 45 45 45 45 45 45 45 45 45 45 45 45 45 45 45 45 45 45 45 00 45 45 45 45 45 45 45
45 45 73 45 45 45 45 00 45 45 45 45 45 45 45 45 45 45 45 45 45 45 45 45 45 45 45 45 45 45 45 45 45 45 45 45 45 45 45 45 45 45 72 45 45 45 72 45 45 45
45 45 72 73 45 45 45 45 45 45 45 45 45 45 45 45 45 45 45 45 45 45 45 45 45 45 45 45 45 45 45 45 45 45 45 45 45 45 45 45 45 45 45 45 45 45 45 45 45 45 
45 45 45 45 45 45 45 45 45 45 45 45 45 45 45 00 00 71 00 00 00 00 00 00 00 00 00 00 00 00 00 00 00 00 00 00 00 00 45 45 45 45 45 45 45 45 45 45 45 45
45 45 45 45 45 45 45 45 45 45 45 45 45 45 45 00 00 71 00 00 00 00 00 00 00 00 00 00 00 71 71 71 71 71 71 00 00 00 45 45 00 00 00 00 00 00 00 00 00 00
45 45 45 45 45 45 45 45 45 45 45 45 45 45 45 00 00 71 00 00 00 00 00 00 00 00 00 00 00 00 00 00 00 00 71 00 00 00 45 45 45 45 45 45 45 45 45 45 45 45
45 45 45 45 45 45 45 45 45 45 45 45 45 45 45 00 00 00 00 00 00 00 00 00 00 00 00 00 00 00 00 00 00 00 71 00 00 00 45 45 45 45 45 45 45 45 45 45 45 45
45 45 45 45 45 45 45 45 45 45 45 45 45 45 45 00 00 71 71 71 71 71 71 71 71 71 00 71 00 00 00 00 00 00 71 00 00 00 45 45 45 45 45 45 45 45 45 45 45 45
45 45 45 45 45 00 00 00 00 00 00 00 00 00 00 00 00 00 00 00 00 00 00 00 00 00 00 00 00 00 00 00 00 00 71 71 71 00 45 45 45 45 45 45 45 45 45 45 45 45
45 45 45 45 45 00 00 00 00 00 00 00 00 00 00 00 00 00 00 00 00 00 00 00 00 71 00 00 00 00 00 00 00 00 00 00 00 00 00 00 00 00 00 45 45 45 45 45 45 45
45 45 45 45 45 00 00 00 00 00 00 00 00 00 00 00 00 71 00 00 00 00 00 00 00 00 00 00 00 00 00 00 00 00 00 00 00 00 00 00 00 00 00 00 00 00 00 00 00 00
45 45 45 45 45 00 00 00 00 00 00 00 00 00 00 00 71 71 00 00 00 00 71 00 00 00 00 00 00 00 00 00 00 00 00 00 00 00 00 00 00 00 00 45 45 45 45 45 45 45
45 45 45 45 45 00 00 00 00 00 00 00 00 00 00 00 00 00 00 00 00 00 00 00 00 00 00 00 00 00 71 71 71 71 00 00 00 00 00 00 00 00 00 45 45 45 45 45 45 45
45 45 45 45 45 00 00 00 00 00 00 00 00 00 00 00 00 00 00 00 00 00 00 00 00 00 00 00 00 00 00 00 00 71 00 00 00 00 00 00 00 00 00 45 45 45 45 45 45 45
45 45 45 45 45 00 00 00 00 00 00 00 00 00 00 00 00 00 00 00 00 00 00 00 71 00 00 00 00 00 00 00 00 71 00 00 00 00 00 00 00 00 00 45 45 45 45 45 45 45
45 45 45 45 45 00 00 00 00 00 00 00 00 00 00 00 00 00 00 00 00 00 00 00 71 00 00 00 00 00 00 00 00 00 00 00 00 00 00 00 00 00 00 45 45 45 45 45 45 45
45 45 45 45 45 00 00 00 00 00 00 00 00 00 00 00 00 00 00 00 00 00 00 00 71 00 00 00 00 00 00 00 00 00 00 00 00 00 00 00 00 00 00 45 45 45 45 45 45 45
45 45 45 45 45 00 00 00 00 00 00 00 00 00 00 00 00 00 00 00 00 00 00 00 71 00 00 00 00 00 00 00 00 00 00 00 00 00 00 00 00 00 00 45 45 45 45 45 45 45
45 45 45 45 45 00 00 00 00 00 00 00 00 00 00 00 00 00 00 00 00 00 00 00 71 00 00 00 00 00 00 00 00 00 00 00 00 00 00 00 00 45 45 45 45 45 45 45 45 45
45 45 45 45 45 00 00 00 00 00 00 00 00 00 00 00 00 00 00 00 00 00 00 00 71 00 00 00 00 00 00 00 00 00 00 00 00 00 00 00 00 45 45 45 45 45 45 45 45 45
45 00 00 45 45 00 00 00 00 00 00 00 00 00 00 00 00 00 00 00 00 00 00 76 76 76 76 76 00 77 00 00 00 00 00 00 00 00 00 00 00 00 45 45 45 45 45 45 45 45
45 45 00 45 45 00 00 00 00 00 00 00 00 00 00 00 00 00 00 00 00 00 00 00 00 00 00 76 00 77 00 00 00 00 00 00 00 00 00 00 00 00 00 45 45 45 45 45 45 45
45 45 45 45 45 45 45 00 00 00 00 00 00 00 00 00 00 75 00 00 00 00 00 00 00 00 00 76 00 77 00 00 00 00 00 00 00 00 00 00 00 00 00 45 45 45 45 45 45 45
45 45 45 45 45 45 45 00 00 00 00 00 00 00 00 00 75 76 74 00 00 00 00 00 00 00 00 76 00 77 00 00 00 00 00 00 00 00 00 00 00 00 00 45 45 45 45 45 45 45
45 45 45 45 45 45 45 00 00 00 00 00 00 00 00 77 76 76 76 74 00 00 00 00 00 00 00 00 77 77 00 00 00 00 00 00 00 00 00 00 00 00 00 45 45 45 45 45 45 45
45 45 45 45 45 45 45 00 00 00 00 00 00 00 00 00 76 76 76 00 00 00 00 00 00 00 00 00 00 00 00 00 00 00 00 00 00 00 00 00 00 00 45 45 45 45 45 45 45 45
45 73 45 45 45 45 45 00 00 00 00 00 00 00 00 00 00 00 00 00 00 00 00 00 00 00 00 00 00 00 00 00 00 00 00 00 00 00 00 00 00 45 45 45 45 45 45 45 45 45
45 45 73 45 45 45 45 00 00 00 00 00 00 00 00 00 00 00 00 00 00 00 00 00 00 00 00 00 00 00 00 00 00 00 00 00 00 45 45 45 45 45 45 45 45 45 45 45 45 45
45 73 45 45 45 45 45 00 00 00 00 00 00 00 00 00 00 00 00 00 00 00 00 00 00 00 00 00 00 00 00 00 00 00 00 00 00 45 45 45 45 45 45 45 45 45 45 45 45 45
45 45 45 45 45 45 45 00 00 00 00 00 00 00 00 00 00 00 00 00 00 00 00 00 00 00 00 00 00 00 00 00 00 00 00 00 00 45 45 45 45 45 45 45 45 45 45 45 45 45
45 45 45 45 45 45 45 45 45 45 45 45 45 00 00 00 00 00 00 00 00 00 00 00 00 00 00 00 00 00 00 00 00 00 00 00 00 45 45 45 45 45 45 45 45 45 45 45 45 45
45 45 45 45 45 45 45 45 45 45 45 45 45 00 00 00 00 00 00 00 00 00 00 00 00 00 00 00 00 00 00 00 00 00 00 00 00 45 45 45 45 45 45 45 45 45 45 45 45 45
45 45 45 45 45 45 45 45 45 45 45 45 45 00 00 00 00 00 00 00 00 00 00 00 00 00 00 00 00 00 00 00 00 00 00 00 00 45 45 45 45 45 45 45 45 45 45 45 45 45
45 45 45 45 45 45 45 45 45 45 45 45 45 00 00 00 00 00 00 00 00 00 00 00 00 00 00 00 00 00 00 00 00 00 00 00 00 45 45 45 45 45 45 45 45 45 45 45 45 45
45 45 45 45 45 45 45 45 45 45 45 45 45 00 00 00 00 00 00 00 00 00 00 00 00 00 00 00 00 00 00 00 00 00 00 00 00 45 45 45 45 45 45 45 45 45 45 45 45 45
45 45 45 45 45 45 45 45 45 45 45 45 45 00 00 00 00 00 00 00 00 00 00 00 00 00 00 00 00 00 00 00 00 00 00 00 00 45 45 45 45 45 45 45 45 45 45 45 45 45
45 45 45 45 45 45 45 45 45 45 45 45 45 00 00 00 00 00 00 00 00 00 00 00 00 00 00 00 00 00 00 00 00 45 45 45 45 45 45 45 45 45 45 45 45 45 45 45 45 45
45 45 45 45 45 45 45 45 45 45 45 45 45 00 00 00 00 00 00 00 00 00 00 00 00 00 00 00 00 00 00 00 00 45 45 45 45 45 45 45 45 45 45 45 45 45 45 45 45 45
45 45 45 45 45 45 45 45 45 45 45 45 45 00 00 00 00 00 00 00 00 00 00 00 00 00 00 00 00 00 00 00 00 45 45 45 45 45 45 45 45 45 45 45 45 45 45 45 45 45
45 45 45 45 45 45 45 45 45 45 45 45 45 45 45 45 45 74 74 00 00 00 00 00 00 00 00 00 00 00 00 75 75 45 45 45 45 45 45 45 45 45 45 45 45 72 73 45 45 45
45 45 45 45 45 45 45 45 45 45 45 45 45 45 45 45 45 75 77 00 00 00 00 00 00 00 00 00 00 00 00 76 76 45 45 45 45 45 45 45 45 45 45 45 45 45 45 73 45 45
45 45 45 45 45 45 45 45 45 45 45 45 45 45 45 45 45 74 75 00 00 00 00 00 00 00 00 00 00 00 00 77 77 45 45 45 45 45 45 45 45 45 45 45 45 45 72 45 45 45
45 45 45 45 45 45 45 45 45 45 45 45 45 45 45 45 45 74 76 00 00 00 00 00 00 00 00 00 00 00 00 75 75 45 45 45 45 45 45 45 45 45 45 45 45 45 45 45 45 45
45 45 45 45 45 72 45 45 45 45 45 45 45 45 45 45 45 75 75 00 00 00 00 00 00 00 00 00 00 00 00 76 76 45 45 45 45 45 45 45 45 45 45 45 45 45 45 45 45 45
45 45 45 45 45 45 45 45 45 45 45 45 45 45 45 45 45 77 74 00 00 00 00 00 00 00 00 00 00 00 00 77 77 45 45 45 45 45 45 45 45 45 45 45 45 45 45 45 45 45
45 45 45 45 45 45 45 45 45 45 45 45 45 45 45 45 45 77 77 00 00 00 00 00 00 00 00 00 00 00 00 74 74 45 45 45 45 45 45 45 45 45 45 45 45 45 45 45 45 45
45 45 45 45 45 45 45 45 45 45 45 45 45 45 45 45 45 74 74 00 00 00 00 00 00 00 00 00 00 00 00 75 75 45 45 45 45 45 45 45 45 45 45 45 45 45 45 45 45 20