3 3 3 3 3 3 3 3 3 3 3 3 3 3 3 3
3 3 3 3 3 3 3 3 3 3 3 3 3 3 3 3
2 2 5 2 2 2 5 2 2 2 2 2 2 2 2 2
2 2 2 2 2 5 2 2 4 4 2 4 4 5 2 2
0 0 0 0 0 0 0 0 4 0 0 0 4 0 0 0
0 0 0 0 0 0 0 0 4 0 0 0 4 0 0 0
0 5 5 5 0 0 0 0 4 0 0 0 4 0 0 0
3 5 5 5 3 3 3 3 4 4 4 4 4 3 3 3
3 5 5 5 3 3 3 3 3 3 3 3 3 3 3 3
1 1 1 1 1 1 1 1 1 1 1 1 1 1 1 1
1 1 1 1 1 1 1 1 1 1 1 1 1 1 1 1
1 1 1 1 1 1 1 1 1 1 1 1 1 1 1 1